9
2.......2
3......1.
.3..55.2.
.......2.
...2....3
.3.4...1.
3...55...
...12....
2....32.3