9
2......53
.34...2..
..4.2....
.5....5..
..2.44...
..1....65
.5..64...
.4.21....
2.....443